111111111111
100000100001
100111110001
100000000011
100100010001
10010P1000E1
100000000001
100000000001
100001100001
111C01100001
11100000C001
111111111111
