111111111111
100000100001
100111110001
100000000011
100100010001
10010P100001
100000000001
100000000001
100001100101
111C011001E1
11100000C1C1
111111111111
